3 5 947 2848 430 2955 604 
1 2 2955 2717 
1 2 604 2717 
1 4 604 2713 1728 1740 
1 6 926 1197 393 3152 2778 2713 
1 2 926 2713 
1 2 2713 2717 
1 4 2200 987 3756 2605 
1 8 2200 3754 2557 2715 1769 3218 1662 2605 
3 6 3772 2943 3767 537 2672 2548
3 14 3767 1996 2247 2674 2646 1690 3808 2570 2120 2512 3776 3775 1679 537 
1 3 3775 3788 2247 
2 2 3775 1996 
2 4 2247 3788 2565 3808
1 5 902 3464 3317 757 3122 
1 7 2548 2036 3049 2542 602 3731 2274 
3 9 3725 3191 2058 3327 2446 3336 2474 2593 2548 
1 3 2274 3001 3327
1 3 2274 2373 3725 
4 3 3191 2172 3719 
1 3 3725 1600 3719 
1 3 2373 4276 987 
3 19 3719 1953 3703 3695 752 1944 2480 3682 2589 2665 236 2894 362 2544 3641 3287 2660 3620 1395 
3 10 1600 1650 1143 2810 3753 610 2693 1677 3720 3716 
2 12 3716 3727 1129 3728 3718 1548 3712 3702 3707 1140 3696 2607 
1 7 2607 3696 352 2924 2079 3678 2665 
1 6 2607 1293 3676 1932 2138 362 
1 8 2138 720 3652 3066 3199 3096 2501 1395 
1 2 2501 3619 
4 3 3719 2662 3720 
2 2 2693 2434 
2 4 3716 3085 687 3703 
1 2 1548 3369 
1 2 2607 1306 
4 3 1600 3733 2693 
2 3 1600 3725 2172 
1 2 3049 2474  
3 7 1423 4822 4800 4801 4802 4805 84 
1 2 4805 4804
1 2 4801 991 
1 2 4800 4803 
4 7 1423 5143 1921 4812 1039 4815 547 
2 4 1039 4814 4816 656 
4 6 656 4817 4821 1320 2409 3157  
4 7 1921 4811 3686 4818 4819 535 3157 
3 4 2409 3157 535 4820 
2 2 535 1920 
2 4 3280 4807 491 1423 
1 2 4821 4819 
1 2 4814 4821 
1 2 547 656 
1 3 3686 4809 2153 
1 5 4805 2304 4796 4806 3639 
1 4 797 1840 4793 748 
1 3 3313 32 4787 
1 4 748 4791 1651 3591 
1 5 3313 3594 2308 3581 2118 
1 4 4787 1276 4786 1241 
1 3 1241 3570 2188 
2 6 4787 32 3628 2834 4790 3639 
1 9 3157 4820 1920 2235 4808 2153 3280 809 3639 
1 32 4955 4954 4072 3129 4091 4107 426 4135 2414 4160 4170 2966 1345 4179 1899 1173 2918 4964 4134 2854 2763 4959 3294 2985 4958 2491 4956 4957 472 4056 4955
1 4 4056 2727 2839 4957 
1 2 2918 2718 
1 2 2854 4131 
1 2 4964 4148 
1 7 3588 3591 2308 3581 1243 1997 3570 
1 3 2478 527 1240 
1 3 1893 1808 1856 
2 4 1241 4785 2426 527 
1 12 527 3267 1902 459 3490 939 3463 2262 526 1171 3106 1893 
1 3 1902 1249 3528 
1 22 4226 2387 4229 4227 3314 2464 4237 759 3003 4243 4244 2776 2386 4241 4240 3277 1895 4234 4231 355 3351 4225 
1 8 4225 4226 2752 4233 3207 2568 1691 4237 
2 3 1282 3679 2781 
1 3 2781 2599 1263 
1 4 2781 2917 3262 1986 
2 3 1282 2425 3700 
4 7 2425 3684 3687 1377 1375 3683 2178 
2 7 1919 3328 167 1446 3706 2559 2425
4 5 2178 3261 647 1642 3739
1 4 647 1680 1412 3711 
1 3 1375 2338 1440 
1 4 167 2147 3694 2338 
1 3 2147 2799 2425 
1 4 1375 2688 1986 532 
1 2 3262 3684 
1 2 2265 3664 
1 5 2487 1239 2381 2318 532 
1 2 3664 2381 
1 3 1239 2236 2688 
3 2 3643 1391 
3 2 2178 770 
1 3 770 1680 1412 
1 2 1412 1336 
2 2 3111 194 
2 5 2487 3674 2497 3134 2555 
3 5 2497 2471 1667 2639 2406 
3 7 770 2613 2378 3689 1464 3693 1545 
3 3 2378 2071 3134 
3 3 3134 972 2471 
2 4 2471 3650 1868 2640 
1 5 2471 1262 1199 544 3357 
4 6 2178 2487 3233 2265 2406 3643 
1 4 3643 141 1301 3357 
1 3 1199 3632 1301 
3 4 1975 1204 3646 2640 
3 3 2555 135 1975 
1 2 2555 1464 
1 3 3650 822 1204 
1 3 3190 2879 287 
3 6 1975 1230 1022 1545 3181 3723 
1 2 3723 3190 
3 4 1975 241 2072 972 
3 5 3734 287 2059 1507 2378 
3 2 3723 3052 
2 3 3052 816 3734 
1 2 3711 287 
2 4 3734 3745 1336 1762 
2 5 1230 499 3298 1502 3721 
1 3 3298 1626 3181 
2 3 3745 469 3769 
1 2 3769 1473 
2 3 1336 3364 3739 
4 3 3739 1642 647 
3 8 797 3630 429 3612 951 1325 2805 1768 
1 4 1680 2020 884 3739 
2 5 3739 3741 731 3740 1931 
2 2 167 1931 
1 4 1440 1919 2940 731 
1 3 1642 2203 1919 
2 10 731 1415 2790 3761 57 984 1746 1300 1514 3804 
1 3 2334 2610 3761 
2 3 1746 3787 3791 
1 9 3740 2005 3744 2872 2334 3196 1705 2944 3804 
1 2 3791 1705 
1 2 3804 3800 
2 3 1746 3068 2941 
4 2 2941 2957
3 3 3068 3802 2957
4 8 2941 3797 2323 2809 3770 2709 3091 3739 
1 2 3181 1507 
1 3 2059 3331 770
1 3 2613 1307 3674 
1 2 3740 1415 
1 4 2709 2216 3768 1415 
1 5 1762 3763 509 3781 1473 
1 3 3781 3777 2773 
2 5 3364 2773 3786 1469 3163 
2 4 3163 2755 1826 3836
2 5 3163 2290 3041 1730 3847 
1 2 2773 3770 
4 8 2651 3350 2128 447 2095 3823 2141 3846 
4 3 3846 2141 3023 
2 4 3769 3765 2650 2651 
3 2 2651 3734 
2 4 2095 410 3105 1225 
2 6 1225 1933 2689 3229 3004 3200
2 3 2755 4049 2941 
2 3 3350 3760 554 
3 2 3052 3738 
3 2 3738 2132 
2 2 3721 2132 
2 5 3721 1832 238 3200 1809 
1 2 2689 2132 
1 3 1225 3762 554 
1 3 1225 3790 1565 
1 7 1565 3059 374 2909 320 3782 2549 
1 7 1565 3240 192 3805 2011 1435 2141 
2 7 3163 3810 3362 1867 2485 2588 2141 
1 4 2588 476 3798 1473 
1 3 1867 1767 3798 
1 7 2588 3830 1830 3149 3227 3305 3847 
1 2 3847 2246 
3 5 3846 3736 3853 1060 3204 
3 8 3204 2197 2843 3884 3139 3879 528 2246 
3 2 3204 2101 
3 7 2246 3322 3836 2408 700 3780 2957 
4 2 2957 1313 
4 4 1313 2618 2429 2070 
3 3 700 1235 2618 
4 3 2070 3304 3321 
4 10 3321 3840 3828 3285 3815 3310 3216 2671 650 2957 
1 2 3285 2946 
3 2 3828 3841 
3 3 3285 3833 2946 
3 4 2671 2460 3343 2070 
3 4 3321 3370 2193 3319 
2 10 3319 1886 3874 3379 1618 3909 2722 3929 2908 2229 
2 5 3379 3151 3010 3858 3370 
1 6 3087 3379 1787 3889 2787 2170 
2 8 3929 3918 2818 3911 3903 3892 3888 2170 
2 4 2170 3861 612 3321 
1 3 1537 2033 2618 
1 5 2745 1166 3859 2998 3886 
1 2 3886 3894 
2 2 3894 2932 
1 6 2932 1319 11 3224 3062 3888 
1 4 11 3882 3265 2998 
2 5 3886 2865 3873 831 3139 
1 9 2197 2731 3922 1781 1748 2661 3380 3180 2932 
1 4 1748 2186 3885 3873 
2 9 612 3854 2239 3856 3848 1537 2745 2375 2408 
3 6 2371 2125 478 219 3852 3846 
3 4 2371 1657 3924 3948 
1 8 1657 3904 960 2728 3102 1862 3307 2101 
1 5 3102 3934 2700 3932 3948 
3 5 3948 1802 3975 2009 3170 
3 12 2101 3289 1773 2250 3962 2569 3973 2602 3119 1789 2358 3008 
1 4 2700 3954 1637 3962 
4 6 394 4156 1352 4172 4177 2877 
4 5 394 3251 1612 4180 4193 
2 18 4180 2875 4183 2530 4196 2053 2418 2583 4208 4207 1397 4210 2055 4212 4213 4214 4221 2956 
1 3 4183 2297 4199 
3 3 394 2016 2875 
3 3 2016 2027 4180 
2 4 4177 1389 2849 2144 
1 2 1389 1352 
1 5 4212 1683 2553 4185 1970 
1 2 1970 2221 
1 5 2221 3176 248 3377 4169 
2 7 4169 3078 2258 1378 2951 4216 339 
1 4 4169 1510 4187 2062 
1 3 4206 1505 1510 
1 6 2062 4206 4205 276 5064 4216 
1 4 1970 1477 4201 3217 
1 3 3217 4204 2062 
1 4 4201 4200 2343 4213 
1 4 2640 2233 1751 2687 
2 4 1751 3236 3602 1113 
2 4 1113 3624 3636 1130 
2 8 1130 3645 1374 1928 1724 680 1976 238 
1 4 2580 23 2192 3636 
1 5 1130 1599 3603 2114 193 
1 4 3357 1587 818 1751 
1 14 818 1254 3353 1200 2979 2852 1007 3515 2543 845 1234 3340 4745 1434 
1 7 193 723 2896 2905 181 3155 4745 
1 4 1434 1492 21 418 
1 3 2687 424 3353 
1 2 418 120 
2 10 1809 1442 1482 880 2734 679 441 3708 2779 277 
1 4 277 2690 614 1990 
1 14 277 1858 3673 3239 1509 1252 2868 2190 915 2988 844 3274 1770 185 
1 3 1990 2422 1252 
1 4 544 1696 607 2640 
1 5 2580 2416 2410 1896 238 
1 5 1975 102 1107 111 2580 
1 5 102 2510 1125 3378 2416 
1 8 1809 3248 636 1934 2124 3671 474 3656 
1 10 3656 1089 3654 4138 872 2103 2551 3325 1453 1599 
3 9 596 2961 2785 2772 1069 3813 385 3829 692 
1 3 596 2549 1442 
3 5 692 3844 1137 1776 3850 
2 4 3850 1201 3297 3829 
1 5 3850 1038 3837 1297 1069 
1 5 1038 1317 227 2296 596 
2 6 692 2325 1733 3115 1151 2330 
1 3 3115 3864 1137 
1 3 3115 3344 1596 
1 13 3138 3075 3938 3949 1495 1771 2526 2987 118 2704 3937 1264 3948 
2 7 3113 4059 3383 2829 1918 2324 3170 
2 9 3008 2617 1782 1634 4112 4130 1428 3276 1352 
3 7 394 4146 4137 4121 4109 1844 3113 
1 3 3113 1699 3008 
2 23 2815 4126 3205 4116 3146 360 1048 4061 1064 2627 1905 4024 4031 4025 2347 2910 3992 3169 3315 1231 3967 2367 2229 
1 2 1064 3109 
1 9 2910 3994 3986 2450 3972 3965 3952 2107 3180 
1 10 3965 2025 1286 3985 3991 3995 2757 935 1913 2281 
1 7 2281 4033 4043 3220 1447 4096 3270 
1 8 360 4089 4078 4062 4053 1598 4041 4033 
1 7 1048 2959 2276 4039 1402 4021 1913 
1 6 4024 2154 4007 3993 3990 3985 
2 4 4007 3035 4002 2347 
1 7 1064 4044 3291 2205 3182 4027 1402 
1 8 3985 2329 3969 3961 3955 3945 2819 3922 
1 6 2281 2337 1546 1989 4018 1789 
2 6 3975 1999 2630 2821 3978 3973 
1 4 2630 1763 2889 3932 
2 11 4146 1645 4098 2028 2838 3144 4067 4054 2230 724 2257 
1 6 2257 2238 2897 2245 4129 2221 
1 4 2221 2169 4151 2759 
1 8 2759 4159 3172 2492 4162 4165 1638 2016 
1 6 1397 4198 4192 2392 1049 4159 
1 7 1397 4195 313 4191 2292 2974 4165 
2 3 3643 2504 1391 
1 7 3975 2288 3996 3197 1098 4013 2257 
1 5 3996 1550 4029 2356 4054 
1 10 2526 1429 2576 2046 3959 2202 1615 3971 3966 3975 
2 4 692 2372 2945 3813 
3 5 3850 2461 1120 3050 2761 
2 2 1120 1317 
2 2 899 3835 
3 6 3835 2300 3851 2625 2117 3023 
2 3 3835 3031 1565 
2 2 3069 1657 
1 7 874 3301 1955 467 5148 1270 118  
1 7 1231 1756 3931 2906 2376 3092 11 
2 3 3344 1322 2761 
1 7 5077 2807 838 2600 5141 2532 938 
1 4 1768 3154 359 2294 
1 11 1301 3147 1958 3593 1811 1127 3601 6 3312 1530 2294 
1 4 1127 3584 1499 3564 
4 13 1391 3111 3629 1104 1394 3621 258 3615 1936 2806 1846 1422 2805
2 3 2806 1813 3622 
2 2 113 3634
3 6 1768 2657 3568 2999 3557 3114  
3 5 3622 1335 2706 2805 1768
1 8 2118 1500 3569 3118 1625 3179 2791 3114 
1 7 3557 2050 2167 1405 2621 2720 748 
1 4 2999 747 2538 1957 
3 6 3114 1356 3532 2402 3512 148 
1 9 2188 3554 3358 451 3539 640 3126 1404 148 
1 6 3554 1457 3552 2581 1094 1240 
1 8 148 599 2475 709 2858 70 2816 2102 
1 5 148 3053 1037 1101 3469 
1 7 1957 888 2298 594 625 3489 1101 
1 8 3114 2377 2983 1538 888 3505 2699 2277 
1 12 3469 1370 3292 2145 1609 387 3450 892 2683 2115 2869 1982 
1 2 1982 1044 
2 20 3463 4766 2332 370 1980 176 466 2102 213 1941 1045 2044 1590 510 2105 364 975 2092 1088 1044 
1 13 1044 2582 2007 3234 584 918 79 515 174 3288 120 1152 1021 
1 3 1902 3538 2384 
1 4 185 2995 1973 1223 
1 6 1223 2244 608 2444 145 3559 
1 4 2972 69 2798 1363 
1 8 2094 1675 3347 2711 1339 1363 3970 431 
1 7 3138 1885 4003 4016 1664 80 1675 
1 7 1675 1433 2143 3330 2179 4163 2111 
1 3 2711 2454 2771 
1 7 2094 4069 344 2694 2286 2520 2258 
1 3 778 5078 2951 
1 8 778 5065 5063 274 1887 2803 4145 2143 
1 21 339 5067 1458 3244 2442 726 2484 5068 131 3186 14 2394 1725 4261 5073 4263 2514 5075 503 4264 5077 
1 3 5077 5076 1943 
1 11 2371 3069 3375 3871 2405 529 874 3189 372 3883 3050 
1 9 1634 4106 4117 4125 3074 2919 3270 4136 2251 
1 4 2144 4147 1185 4117 
1 2 1921 1284 
3 5 84 3635 4795 1840 797 
3 10 4177 4178 3089 1398 4167 964 4168 2913 2251 2815 
1 5 964 4158 2284 4141 4125 
3 5 2647 113 2950 3346 3622